1111111111111111111
1P00000000000000C01
1000111111110111101
1000100000000100001
1011111011111111001
1C00001000000000C01
1000111111110111101
10001000000001000E1
1111111111111111111