1111111111111111111111
1P00000000000C00000011
1000111111101111111101
1000000000100000000001
1011111111111111111101
1000000000000000000001
1111111111011111111111
100000000C0000000000E1
1011111111111111111101
10000000000000000C0001
1111111111111111111111