11111111111111111111111111111111
1P000000000000C00000000000000001
10001111111111111111111111111101
10000000000000000000000000000001
10111111111111111111111111111101
1C000000000000000000000000000C01
10111111111111111111111111111101
10000000000000000000000000000001
10111111111111111111111111111111
1C0000000000000000000000000000E1
10111111111111111111111111111101
10000000000000000000000000000001
11111111111111111111111111111111