11111111111111111111
1P00000000C000000001
10001111110111111101
10000000000000000101
10111111110111110101
10000000000100000001
11110111111111111101
10000000000000000001
10111111111111111101
10000000000000C00001
10001111110111111001
1C00000000000000E001
11111111111111111111