1111111111111111111
1P00000000100000C01
1000111111011111101
1000100000000000101
1000111111111010101
1C000000000000C0001
1111101111111011111
1000000000000000E01
1000111111111100011
100000000000000C001
1111111111111111111