1111111111111111111111111111111
1P000000000000C0000000000000001
1000111111111111111111111111101
1000000000000000000000000000001
1111111111111011111111111111101
1C00000000000100000000000000001
1011111111111111111111111111101
1000000000000000000000000000001
1111111111111111111111111111111
10000000000000000000000000000E1
1000111111111111111111111111101
1C00000000000000000000000000001
1111111111111111111111111111111