11111111111111111111111111111111111111
1P000000000000C10000001C100011C0000001
1000000000010000001000000010010000C001
10111111110111111011111111110111111001
101C00000001000000000C000000C0000000C1
10111111111111111111111111111011111101
10000000000000000000000000000100000001
11111111111111111111011111111111000001
10000000000000000000000000000000000001
10011111111111111111111111111111111001
10000000000000000000000000000000000001
10111111111111011111110111111111111101
100000000000C1000000C10000000000000001
10111111111011111111111111111111111101
1C000000000000000C1C0000C0000000000001
10111111111111111111111111111111111101
10000000000C1000000000001E000000000001
100011111111100000100000C0000000000001
1000000000000000001C000010000000000001
11111111111111111111111111111111111111