1111111111111111111111111
1P00000000000000000000011
1110111011110111C111C1111
100C10001C010000100010011
1011111111011111111111011
1000000000C0000000000C001
1011111111011111111111011
1000000000010000000000011
1000000000C000000C0000C01
1110111011011110111011011
1000100010010000100010011
1011101111011110111011011
1000000000C0000000000C001
1011111111011111111111011
100000000C010000000000011
1110111011011110111011011
1E0000C000000000000000011
1111111111111111111111111