111111111111111111111
1P00000000000C0000001
100011111111111110001
100000000000000000001
111111111101111111111
1C0000000000000000001
101111101111111111101
1000000000000000000E1
101111111111111111101
10000000000000C000001
111111111111111111111