1111111
10000P1
101C101
1000101
1010001
1C00E01
1111111