1111111
1P00001
101C101
1000101
1010001
1C00E01
1111111