1111111111
1P00000001
1000111111
1000010001
101C001001
1000000C01
1010000001
100C000001
1000000E01
1111111111