111111111111
1P0000000001
100111111C01
100000000001
1C0111000001
100010000001
10000C00E001
111111111111