111111111111111
1P0000000000001
100001111110001
1000000000C0001
101C00000100001
100011111010001
1000000C0000001
100001001000C01
10000E000000001
111111111111111