111111111111111
1P000000000C001
100011111000001
100010000C00001
101111011110001
10000C000000C01
100011111100001
100000000000E01
111111111111111