111111111111111
1P000C000000001
100011111110001
100C00000000001
101110111111001
100000C00000E01
100011111100001
1C0000000000001
111111111111111