1111111111111111
1P00000000000001
1000111111110001
10000000C0000001
1011111011111101
1000000000000E01
1000111111000001
1C0000000C000001
1111111111111111