11111111
11111111
1C001E11
10000P01
11111111