111111
1P 001
100001
1C0E1
111111