111111
1P0001
100001
1C001
011111
