111111
100001
100001
1C0001
111111
