11111111
1P0000001
10000000E
1C0000001
11111111
