111111111
1P10000C1
1E0000C01
1C00000C1
111111111